111111111111111111111111
100000000000000001000001
100000000000000000100001
100001111111000000010001
100000000000000000000001
111111111111100001111111
100000000000000000000P01
100000111111111000000001
1100C000000C00000000C001
1E100000000000000C000001
111111111111111111111111
