111111111111111111111111
100000000000000001000001
100000000000000000100P01
100001111111001000010001
100000000000010100000001
111111111111100001111111
10000000000000000E100001
100010111111111001000001
1000C000000C00000000C001
10000100000000000C000001
111111111111111111111111
