111111111111111111111111
100000000000000001000001
100000000000000000100P01
100001111111001000010001
1000000000000101E0000001
111111111111100001111111
100000000000000000000001
100010111111111000000001
1001C100000C00000000C001
10000100000000000C000001
111111111111111111111111
